border_size=1
usage=map

Gg          , Gg          , Gg          , Gg          , Gg          , Gg          , Gg          , Gg          , Gg          , Gg          , Gg          , Gg          , Hh          , Hh          , Mm          , Mm          , Mm          , Mm          , Mm          , Mm          , Mm          , Mm          , Hh          , Hh          , Hh          , Gs^Fms      , Gs^Fms      , Gs^Fms      , Gs^Fms      , Gs^Fms      , Gs^Fms      , Gs^Fms      , Gs^Fms      , Gs^Fms      , Gs^Fms      , Gs^Fms      , Gs^Fms      , Gs^Fms      , Gs^Fms      , Gs^Fms      , Gs^Fms      , Gs^Fms      , Ww          , Ww          , Ww          , Gg          
Gg          , Gg          , Gg          , Gg          , Gg          , Gg          , Gg          , Gg          , Gg          , Gg          , Hh          , Hh          , Hh          , Hh          , Mm          , Mm          , Mm          , Mm          , Mm          , Mm          , Mm          , Mm          , Hh          , Hh          , Hh          , Gs^Fms      , Gs^Fms      , Gs^Fms      , Gs^Fms      , Gs^Fms      , Gs^Fms      , Gs^Fms      , Ww          , Gs^Fms      , Ww          , Gs^Fms      , Gs^Fms      , Gs^Fms      , Gs^Fms      , Gs^Fms      , Gs^Fms      , Gs^Fms      , Ww          , Ww          , Ww          , Gg          
Gg          , Gg          , Gs^Vh       , Gg          , Gg          , Gg          , Gg          , Gg          , Gg          , Gg          , Hh          , Hh          , Hh          , Hh          , Hh          , Mm          , Hh          , Hh          , Hh          , Mm          , Mm          , Mm          , Hh          , Hh          , Gg          , Gg          , Gg          , Gs^Fms      , Ww          , Gs^Fms      , Ww          , Ww          , Ww          , Ww          , Ww          , Ww          , Ww          , Ww          , Ww          , Gs^Fms      , Ww          , Ww          , Ww          , Ww          , Ww          , Gg          
Gg          , Gg          , Gg          , Gg          , Gg          , Gg          , Gg          , Gg          , Gg          , Gg          , Gg          , Mm          , Gg          , Gg          , Gg          , Gg          , Gg          , Hh          , Hh          , Hh          , Hh          , Hh          , Hh          , Hh          , Gg          , Gg          , Ww          , Ww          , Ww          , Ww          , Ww          , Ww          , Ww          , Ww          , Ww          , Ww          , Ww          , Ww          , Ww          , Ww          , Ww          , Ww          , Ww          , Ww          , Gg          , Gg          
Gg          , Gg          , Gg          , Gg          , Gg          , Gg          , Gg          , Gg          , Gg          , Gg          , Gs^Vh       , Gg          , Ce          , Gg          , Gg          , Gg          , Gg          , Hh          , Ce          , Hh          , Gg          , Hh          , Gg          , Gg          , Ww          , Ww          , Ww          , Ww          , Ww          , Ww          , Ww          , Ww          , Gg          , Ww          , Ce          , Ww          , Ww          , Ww          , Ww          , Ww          , Ww          , Ww          , Ce          , Gg          , Gg          , Gg          
Gg          , Gg          , Gg          , Gg          , Gg          , Gg          , Gg          , Gg          , Gg          , Gg          , Gg          , Ce          , 2 Ke        , Ce          , Gg          , Gg          , Gg          , Gg          , Rr          , Gg          , Gg          , Gg          , Gg          , Gg          , Ww          , Ww          , Ww          , Ww          , Gg          , Ce          , Gg          , Gg          , Gg^Wm       , Gg          , Gg          , Gg          , Gg          , Gg          , Gg          , Gg          , Gg          , Gg^Wm       , Gg          , Gg          , Gg          , Gg          
Gg          , Gg          , Gg          , Gg          , Gg          , Gg          , Gg          , Gg          , Gg          , Gg          , Gg          , Ce          , Ce          , Ce          , Gg          , Gg          , Rr          , Rr          , Ce          , Rr          , Rr          , Gg          , Ww          , Ww          , Ww          , Ww          , Ww          , Gg          , Gg          , Gg          , Gg          , Gg          , Gg          , Gg          , Gd^Gvs      , Gg          , Gg          , Gg^Eff      , Gg^Eff      , Gg          , Gg          , Gg          , Gg          , Gg          , Gg^Gvs      , Gg          
Gg          , Gg          , Gg          , Gg          , Gg          , Gg          , Gg          , Gg          , Gg          , Gg          , Gg          , Gg          , Gg          , Gg          , Rr          , Rr          , Gg          , Gg          , Gg          , Gg          , Gg          , Rr          , Ww^Bsb\     , Ww          , Ww          , Ww          , Gg          , Gg          , Gg          , Gg          , Gs^Vh       , Gg          , Gd^Gvs      , Gd^Gvs      , Gd^Gvs      , Gd^Gvs      , Gd^Gvs      , Gg          , Gg^Eff      , Gg^Eff      , Gg          , Gs^Vh       , Gg^Gvs      , Gg^Gvs      , Gg^Gvs      , Gg          
Gg          , Gg          , Gg          , Gg          , Gg          , Gg          , Gg          , Gg          , Gg          , Gg          , Gg          , Gg          , Rr          , Rr          , Gg          , Gg          , Gs^Vh       , Gg          , Gg          , Gg          , Ww          , Ww          , Ww          , Ww^Bsb\     , Rr          , Ch          , Gg          , Gg          , Gg          , Gg          , Gg          , Gd^Gvs      , Gd^Gvs      , Gd^Sca      , Gd^Gvs      , Gd^Gvs      , Gg          , Gg^Eff      , Gg^Eff      , Gg          , Gg^Gvs      , Gg^Gvs      , Gg^Gvs      , Gg^Sca      , Gg^Gvs      , Gg          
Gg          , Gg          , Gg          , Gg          , Gg          , Gg          , Gg          , Gg          , Gg          , Gg          , Rr          , Rr          , Gg          , Gg          , Gg          , Gg          , Gg          , Gg          , Gg          , Gg          , Ww          , Ww          , Ww          , Ch          , Gg          , Rr          , Rr          , Gg          , Gg          , Gg          , Gg^Eff      , Gg          , Gg          , Gd^Gvs      , Gg          , Gs^Vh       , Gg          , Gg          , Gg^Eff      , Gg^Eff      , Gg^Eff      , Gg^Gvs      , Gg^Gvs      , Gg^Gvs      , Gg          , Gg          
Rr          , Gg          , Gg^Sig      , Gg          , Gg          , Gg          , Rr          , Gg          , Rr          , Rr          , Gg          , Gg          , Gg          , Gg          , Gg          , Gg          , Gg          , Gg^Es       , Ww          , Ww          , Ww          , Ww          , Ww          , Gg          , Gg          , Gg          , Gg          , Rr          , Rr          , Gg          , Gg          , Gg^Eff      , Gg^Eff      , Gg          , Gg          , Gg          , Gg^Eff      , Gg          , Gg          , Gg          , Gg          , Gg          , Gg^Eff      , Gg          , Gg^Efm      , Gg          
Gg          , Rr          , Rr          , Gg          , Rr          , Rr          , Gg          , Rr          , Gg          , Gg          , 1 Ke        , Ce          , Gg          , Gg          , Gg          , Gg          , Ww          , Ww          , Ww          , Ww          , Ww          , Ww          , Gg          , Gg          , Gg          , Gg          , Gg          , Gg          , Rr          , Gg          , Gg          , Gg          , Gg          , Gg^Eff      , Gg^Eff      , Gg^Eff      , Gg^Gvs      , Gg^Gvs      , Gg^Wm       , Gg          , Rr          , Gg          , Gs^Vh       , Gg^Eff      , Gg^Eff      , Gg          
Gg          , Gg          , Gg          , Rr          , Gg          , Gg          , Gg          , Gg          , Gg          , Ce          , Ce          , Ce          , Gg          , Gg          , Gg          , Gg          , Ww          , Ww          , Ww          , Ww          , Gg          , Gg          , Gg          , Gg          , Gg          , Gs^Vh       , Rr^Vhc      , Rr^Vhc      , Rr          , Rr^Vhc      , Rr^Vhc      , Gg          , Gg          , Gg          , Gg^Gvs      , Gg^Gvs      , Gg^Sca      , Gg          , Gg^Gvs      , Gg          , Rr          , Gg          , Gg          , Gg          , Gg          , Gg^Eff      
Gg          , Gg          , Gg          , Gg          , Gg          , Gg          , Gg          , Gg          , Gg          , Gg          , Gg          , Gg          , Gg          , Gg          , Ww          , Ww          , Ww          , Ww          , Ww          , Ww          , Gg          , Gg          , Gs          , Gg          , Gg          , Gg          , Rr          , Rr          , Rr^Vhc      , Rr          , Rr          , Gg          , Gg          , Gg          , Gg          , Gg          , Gg^Gvs      , Gg^Gvs      , Gg          , Gg          , Rr          , Gg          , Gg          , Gs^Fms      , Gs^Fms      , Gg          
Gg          , Gg          , Gg          , Gg          , Gg          , Gg          , Gg          , Gs^Vh       , Gg          , Gg          , Gg          , Gg          , Ww          , Ww          , Ww          , Ww          , Ww          , Ww          , Gg          , Gg          , Gg          , Gs          , Gg          , Gg          , Rr          , Rr          , Gg          , Rr^Vhc      , Gg          , Rr^Vhc      , Gg          , Rr          , Gg          , Gg          , Gg          , Gg^Gvs      , Gg          , Gg          , Gg          , Gg^Efm      , Rr          , Gg          , Gg          , Gs^Fms      , Gg          , Gg          
Gg          , Gg          , Gg          , Gg          , Gg          , Gg          , Gg          , Gg          , Gg          , Gg          , Gg          , Gg          , Ww          , Ww          , Ww          , Ww          , Ww          , Ce          , Gg          , Gg          , Gg          , Gs          , Gg          , Rr          , Gg          , Gg          , Gg          , Gg          , Gg          , Gg          , Gg          , Rr          , Gg          , Gg          , Ch          , Ch          , Ch          , Gg          , Gg          , Gg          , Rr          , Gg          , Gg          , Gg          , Gg          , Gg          
Gg          , Gg          , Gg          , Gg          , Gg          , Gg          , Gg          , Gg          , Gg          , Gg          , Gg          , Gg          , Gg^Es       , Ww          , Ww          , Ww          , Ww          , Ww          , Ww          , Gg          , Gg          , Gg          , Gg          , Rr          , Gs^Vh       , Gg          , Gg          , Gg          , Gg^Efm      , Gg          , Gg          , Rr          , Rr          , Gg          , Ch          , 3 Kh        , Ch          , Gg          , Rr          , Rr          , Gg          , Gg          , Gg          , Gg          , Gg          , Gg          
Gg          , Gg          , Gs^Vh       , Gg          , Gg          , Gg          , Gg          , Gg          , Gg          , Gg          , Gg          , Gg          , Gg          , Gg          , Gg          , Ww          , Ww          , Ww          , Ww          , Gg^Es       , Gg          , Gg          , Gg          , Rr          , Gg          , Gg          , Gg          , Gg          , Gg          , Gg          , Gg          , Gg          , Gg          , Rr          , Rr          , Ch          , Rr          , Rr          , Gg          , Gs^Vh       , Gg          , Gg          , Gg          , Gg          , Gg          , Gg          
Gg          , Gg          , Gg          , Gg          , Gg          , Gg          , Gg          , Gg          , Gs^Fds      , Gg          , Gg          , Gg          , Gg          , Gg          , Ww          , Ww          , Ww          , Ww          , Ww          , Gg          , Gg          , Gg          , Gg          , Gg          , Gg          , Gg          , Gs^Fds      , Gs^Fds      , Gg          , Gg          , Gg^Es       , Gg          , Gg          , Gg          , Gg          , Rr          , Gg          , Gg          , Gg          , Gg          , Gg          , Gg          , Gg          , Gg          , Gg          , Gg          
Gg          , Gg          , Gg          , Gg          , Gg          , Gg          , Gs^Fds      , Gs^Fds      , Gs^Fds      , Gs^Fds      , Gs^Fds      , Gs^Fds      , Gg          , Gg          , Ww          , Ww          , Ww          , Ww          , Gs^Fds      , Gs^Fds      , Gs^Fds      , Gg          , Gg^Efm      , Gg          , Gg          , Gg          , Gs^Fds      , Gs^Fds      , Gg          , Gg          , Gg          , Gg          , Gg          , Gg          , Gg          , Rr          , Gg          , Gg          , Gg          , Gg          , Gs^Fds      , Gs^Fds      , Gg          , Gg          , Gg          , Gg          
Gg          , Gg          , Gs^Fds      , Gs^Fds      , Gs^Fds      , Gs^Fds      , Gs^Fds      , Gs^Fds      , Gs^Fds      , Gs^Fds      , Gs^Fds      , Gs^Fds      , Gg          , Ww          , Ww          , Ww          , Ww          , Ce          , Gs^Fds      , Gs^Fds      , Gs^Fds      , Gg          , Gg          , Gg          , Gg          , Gg          , Gg          , Gs^Fds      , Gg          , Gg          , Gs^Vh       , Gg          , Gg          , Gg          , Gg          , Rr          , Gg          , Gg          , Gg          , Gg          , Gg          , Gs^Fds      , Gg          , Gg          , Gg          , Gg          
Gs^Fds      , Gs^Fds      , Gs^Fds      , Gs^Fds      , Gs^Fds      , Gs^Fds      , Gs^Fds      , Gs^Fds      , Gs^Fds      , Gs^Fds      , Gs^Fds      , Gs^Fds      , Gs^Fds      , Ww          , Ww          , Ww          , Ww          , Gs^Fds      , Gs^Fds      , Gs^Fds      , Gs^Fds      , Gs^Fds      , Gg          , Gg          , Gg          , Gg          , Gg          , Gg          , Gg          , Rr          , Rr          , Gg          , Gg          , Gg          , Rr          , Rr          , Gg          , Gg          , Gg          , Gg          , Gg          , Gg          , Gg          , Gg          , Gg          , Gg          
Gs^Fds      , Gs^Fds      , Gs^Fds      , Gs^Fds      , Gs^Fds      , Gs^Fds      , Gs^Fds      , Gs^Fds      , Gs^Fds      , Gs^Fds      , Gs^Fds      , Gs^Fds      , Gs^Fds      , Ww          , Ww          , Ww          , Ce          , Gs^Fds      , Gs^Fds      , Gs^Fds      , Gs^Fds      , Gg          , Gg          , Gs^Vh       , Gg          , Gg          , Gg          , Gg          , Gg          , Gg          , Gg          , Rr          , Rr          , Rr          , Gg          , Gg          , Gg          , Gg          , Gg          , Gg^Efm      , Gg          , Gg          , Gg          , Gg          , Gg          , Gg          
Gs^Fds      , Gs^Fds      , Gs^Fds      , Gs^Fds      , Gs^Fds      , Gs^Fds      , Gs^Fds      , Gs^Fds      , Gs^Fds      , Gs^Fds      , Gs^Fds      , Gs^Fds      , Gs^Fds      , Ww          , Ww          , Ww          , Gs^Fds      , Gs^Fds      , Gs^Fds      , Gs^Fds      , Gg          , Gg          , Gg          , Gg          , Gg          , Gg          , Gg          , Gg          , Gg          , Gg          , Gg          , Gg          , Gg          , Gg          , Gg          , Gg          , Gg          , Gg          , Gg          , Gg          , Gg          , Gg          , Gg          , Gg          , Gg          , Gg          
